Order: Serial number of property
PID : Property Identifier
MS SubClass: The building class
MS Zoning: The general zoning classification
Lot Frontage: Linear feet of street connected to property
Lot Area: Lot size in square feet
Street: Type of road access
Alley: Type of alley access
Lot Shape: General shape of property
Land Contour: Flatness of the property
Utilities: Type of utilities available
Lot Config: Lot configuration
Land Slope: Slope of property
Neighborhood: Physical locations within Ames city limits
Condition 1: Proximity to main road or railroad
Condition 2: Proximity to main road or railroad (if a second is present)
Bldg Type: Type of dwelling
House Style: Style of dwelling
Overall Qual: Overall material and finish quality
Overall Cond: Overall condition rating
Year Built: Original construction date
Year RemodAdd: Remodel date
Roof Style: Type of roof
Roof Matl: Roof material
Exterior 1st: Exterior covering on house
Exterior 2nd: Exterior covering on house (if more than one material)
Mas Vnr Type: Masonry veneer type
Mas Vnr Area: Masonry veneer area in square feet
Exter Qual: Exterior material quality
Exter Cond: Present condition of the material on the exterior
Foundation: Type of foundation
Bsmt Qual: Height of the basement
Bsmt Cond: General condition of the basement
Bsmt Exposure: Walkout or garden level basement walls
BsmtFin Type 1: Quality of basement finished area
BsmtFin SF 1: Type 1 finished square feet
BsmtFin Type 2: Quality of second finished area (if present)
BsmtFin SF 2: Type 2 finished square feet
Bsmt Unf SF: Unfinished square feet of basement area
Total Bsmt SF: Total square feet of basement area
Heating: Type of heating
Heating QC: Heating quality and condition
Central Air: Central air conditioning
Electrical: Electrical system
1st Flr SF: First Floor square feet
2nd Flr SF: Second floor square feet
Low Qual Fin SF: Low quality finished square feet (all floors)
Gr Liv Area: Above grade (ground) living area square feet
Bsmt Full Bath: Basement full bathrooms
Bsmt Half Bath: Basement half bathrooms
Full Bath: Full bathrooms above grade
Half Bath: Half baths above grade
Bedroom AbvGr: Number of bedrooms above basement level
Kitchen AbvGr: Number of kitchens
Kitchen Qual: Kitchen quality
TotRms AbvGrd: Total rooms above grade (does not include bathrooms)
Functional: Home functionality rating
Fireplaces: Number of fireplaces
Fireplace Qu: Fireplace quality
Garage Type: Garage location
Garage Yr Blt: Year garage was built
Garage Finish: Interior finish of the garage
Garage Cars: Size of garage in car capacity
Garage Area: Size of garage in square feet
Garage Qual: Garage quality
Garage Cond: Garage condition
Paved Drive: Paved driveway
Wood Deck SF: Wood deck area in square feet
Open Porch SF: Open porch area in square feet
Enclosed Porch: Enclosed porch area in square feet
3Ssn Porch: Three season porch area in square feet
Screen Porch: Screen porch area in square feet
Pool Area: Pool area in square feet
Pool QC: Pool quality
Fence: Fence quality
Misc Feature: Miscellaneous feature not covered in other categories
Misc Val: $Value of miscellaneous feature
Mo Sold: Month Sold
Yr Sold: Year Sold
Sale Type: Type of sale
Sale Condition: Condition of sale
SalePrice: the property's sale price in dollars. 